1111111111
10000000C1
10000000C1
10000000C1
1000000001
10000000C1
10000000C1
10000P0001
1E000000C1
1111111111